Гор Луперкаль – Магистр Войны, примарх XVI Легиона

Мортарион – Повелитель Смерти, примарх XIV Легиона

Фулгрим – Фениксиец, примарх III Легиона

Леман Русс – Волчий Король, примарх VI Легиона

Рогал Дорн – Преторианец Императора, примарх VII Легиона

 


 

Эзекиль Абаддон – Первый капитан

Фальк Кибре – «Вдоводел», капитан, отделение терминаторов-юстаэринцев

Калус Экаддон – капитан, отделение Катуланских Налетчиков
Гор Аксиманд – капитан, Пятая рота

Йед Дурсо – линейный капитан, Пятая рота

Сергар Таргост – капитан, Седьмая рота, магистр ложи

Лев Гошен – капитан, 25-я рота

Граэль Ноктуа – «Заколдованный», сержант, 25-я рота

Малогарст – «Кривой», советник примарха

Гер Гераддон – луперк

 


 

Каифа Морарг – 24-е прорывное отделение, Вторая рота

Игнаций Грульгор – Пожиратель Жизней

 


 

Кастор Алкад – легат

Дидакус Ферон – центурион, Четвертый дивизион

Проксимо Тархон – центурион, Девятый дивизион

Аркадон Киро – технодесантник



 

Витус Саликар – капитан, 16-я рота

Аликс Вастерн – апотекарий

Дразен Акора – назначенный лейтенант, ранее входил в Библиариум

Агана Серкан – надзиратель

 


 

Этана Калонис – принцепс, «Идеал Терры»

Картал Ашур – калатор мартиалис

 


 

Ута-Дагон – принцепс, «Красная Месть»

Уту-Лерна – принцепс, «Кровавая Подать»

Ур-Намму – Разжигатель Войны

 


 

Опиник – инвокацио



 

Беллона Модвен – верховный магос, Ордо Редуктор

 


 

Киприан Девайн – «Адский клинок», рыцарь-сенешаль

Себелла Девайн – супруга-дракайна

Рэвен Девайн – первый рыцарь

Альбард Девайн – перворожденный отпрыск

Ликс Девайн – супруга-сибарис



 

Балморн Донар – лорд-рыцарь

Робард Донар – отпрыск



 

Малкадор Сигиллит – Имперский Регент, Первый Лорд Терры

Бритон Семпер – лорд-адмирал Молехского боевого флота

Тиана Курион – лорд-генерал гранд-армии Молеха

Эдораки Хакон – маршал Северного Океанического

Абди Хеда – командующий Кушитским Востоком

Оскур ван Валькенберг – полковник Западных Пределов

Корвен Мальбек – хан Южной Степи

Ноама Кальвер – медицинский корпус

Аливия Сурека – пилот гавани Ларса

Джеф Парсон – докер

Миска – ввв

Вивьен – ввв

 


 

Гарвель Локен – Странствующий Рыцарь

Йактон Круз – «Вполуха», Странствующий Рыцарь

Севериан – Странствующий Рыцарь

Тилос Рубио – Странствующий Рыцарь

Мейсер Варрен – Странствующий Рыцарь

Брор Тюрфингр – Странствующий Рыцарь

Рама Караян – Странствующий Рыцарь

Арес Войтек – Странствующий Рыцарь

Алтан Ногай – Странствующий Рыцарь

Каллион Завен – Странствующий Рыцарь

Тубал Каин – Странствующий Рыцарь

Бану Рассуа – пилот «Тарнхельма»